1
11 9
xxxxxxxxxxx
xxx     xxx
xxp x x pxx
x   x x   x  
x x x x x x
x   x x   x
xxp x x pxx
xxx     xxx
xxxxxxxxxxx